Name	Cluster
abis leuven	Free University of Brussels
acev antwerp	University of Antwerp
acta antwerpen	University of Antwerp
activities and societies member board of director opb onthaal promotie brussel since march	Solvay Business School
activities and societies semini leuven finance skills program	Vlerick Business School
adeb vba ulb vub	Free University of Brussels
advanced management bij vlerick	Vlerick Business School
ahsal management school brussels	Solvay Business School
aig ucl louvain la neuve	Catholic University of Leuven
alcatel university antwerpen	University of Antwerp
antwerp university	University of Antwerp
antwerpen	University of Antwerp
antwerpen acb	University of Antwerp
ap antwerpen	University of Antwerp
ap hogeschool antwerpen	University of Antwerp
artesis plantijn antwerpen	University of Antwerp
atheneum antwerpen	University of Antwerp
atic leuven	Catholic University of Leuven
belgisch textiel en kunststoffen instituut gent	Catholic University of Leuven
beta vzw uia antwerpen	University of Antwerp
brucemo brussel	Free University of Brussels
brussel	Free University of Brussels
brussel formation	Free University of Brussels
brussel opleiding	Free University of Brussels
brussels chamber of commerce	Free University of Brussels
brussels polytechnical school	Solvay Business School
c t l gent	Catholic University of Leuven
c v o gent	University of Ghent
cae oxford aviation academy brussels	Free University of Brussels
captains table gent	Catholic University of Leuven
catapult brussel	Free University of Brussels
catholic university leuven belgium	Catholic University of Leuven
catholic university louvain	Catholic University of Leuven
catholic university of leuven	Catholic University of Leuven
catholic university of leuven faculty of medicine	Catholic University of Leuven
catholic university of leuven faculty of pharmaceutical sciences	Catholic University of Leuven
catholic university of leuven kul	Catholic University of Leuven
centrum voor levende talen clt leuven	Catholic University of Leuven
centrum voor volwassenenonderwijs antwerpen	University of Antwerp
charles buls in brussel	Free University of Brussels
commercial engineer at ku leuven	Catholic University of Leuven
cours industriels brussel	Free University of Brussels
cpme uclouvain	Catholic University of Leuven
de economie culture club ghent co founder clash icc gent weekly events	Catholic University of Leuven
e h s a l brussel	Free University of Brussels
ecam brussel	Free University of Brussels
ecam brussels	Free University of Brussels
ecam brussels engineering	Free University of Brussels
ecam brussels engineering school	Solvay Business School
ecole centrale des arts et metiers brussel	Free University of Brussels
ecole polytechnique de louvain	Catholic University of Leuven
ecole polytechnique de louvain la neuve	Catholic University of Leuven
ecole polytechnique de louvain option aeronautique	Catholic University of Leuven
ecole polytechnique de louvain uclouvain	Catholic University of Leuven
ecole provinciale d aide medicale urgente	Vlerick Business School
economic high school saint aloysius brussels belgium	Free University of Brussels
egon gent	University of Ghent
ehb vub	Free University of Brussels
encora antwerpen	University of Antwerp
epfc brussel	Free University of Brussels
ephec brussel	Free University of Brussels
erasmus brussel hogent	Free University of Brussels
erasmus hoge school brussel	Free University of Brussels
erasmus hogeschool brussel	Free University of Brussels
erasmushogeschool brussel	Free University of Brussels
erasmushogeschool brussel rits	Free University of Brussels
european school of brussels	Free University of Brussels
europese hogeschool brussel	Free University of Brussels
filmschool narafi brussel	Free University of Brussels
fiscale hogeschool brussel	Free University of Brussels
free technical school antwerp	University of Antwerp
geel ku leuven	Catholic University of Leuven
gent	University of Ghent
gent ihrs	University of Ghent
gent u	University of Ghent
gent unif	University of Ghent
gent universiteit	University of Ghent
ghent univerity	University of Ghent
ghent university	University of Ghent
go centrum voor volwassenenonderwijs antwerpen	University of Antwerp
groep t campus vesalius leuven	Catholic University of Leuven
groep t hogeschool leuven	Catholic University of Leuven
groep t in leuven	Catholic University of Leuven
groep t internationale hogeschool leuven	Catholic University of Leuven
groep t kuleuven	Catholic University of Leuven
groep t leuven	Catholic University of Leuven
groep t leuven engineering school	Catholic University of Leuven
groep t leuven hogeschool	Catholic University of Leuven
groep t te leuven	Catholic University of Leuven
groept ku leuven	Catholic University of Leuven
groept leuven	Catholic University of Leuven
groept t leuven	Catholic University of Leuven
group t leuven	Catholic University of Leuven
groupt leuven	Catholic University of Leuven
guberna vlerick business school	Vlerick Business School
h r i t o hasselt	University of Hasselt
handelshogeschool antwerpen	University of Antwerp
hasselt	University of Hasselt
hasselt en leuven	University of Hasselt
hasselt university	University of Hasselt
haute ecole de louvain en hainaut	Catholic University of Leuven
haute ecole louvain en hainaut	Catholic University of Leuven
heilig hart hasselt	University of Hasselt
hi st lieven gent	University of Ghent
higro gent	University of Ghent
hl hasselt	University of Hasselt
hlto hasselt step	University of Hasselt
hoge school universiteit brussel	Free University of Brussels
hogent unief gent	University of Ghent
hogeschool antwerpen dep ontwerpwetenschappen	University of Antwerp
hogeschool brussel	Free University of Brussels
hogeschool sint lukas brussel	Free University of Brussels
hogeschool universiteit brussel	Free University of Brussels
honim brussel	Free University of Brussels
hrito hasselt	University of Hasselt
hrito te hasselt	University of Hasselt
hti st lieven gent	University of Ghent
hub kubrussel	Free University of Brussels
huis van het nederlands brussel	Free University of Brussels
hzs antwerp	University of Antwerp
i l t k u l leuven	Catholic University of Leuven
iag louvain la neuve	Catholic University of Leuven
iag universite catholique de louvain	Catholic University of Leuven
ibm brussel	Free University of Brussels
icc brussels	Free University of Brussels
icrc brussels	Free University of Brussels
ih groep te leuven	Catholic University of Leuven
iham antwerp	University of Antwerp
iham antwerpen	University of Antwerp
ihb brussels	Free University of Brussels
ihbr brussel	Free University of Brussels
ihgl hasselt	University of Hasselt
ihgl hasselt xios	University of Hasselt
ihr brussel	Free University of Brussels
ihr gent	University of Ghent
ihr hasselt mol	University of Hasselt
ihrb industriele hogeschool brussel	Free University of Brussels
ihrh hasselt	University of Hasselt
ihsr gent	University of Ghent
industriele hogeschool brussel	Free University of Brussels
industriele hogeschool brussel erasmus	Free University of Brussels
industriele hogeschool te brussel	Free University of Brussels
informazout cedicol vzw brussel	Free University of Brussels
institut paul henri spaak isib brussel	Free University of Brussels
institut paul lambin brussels belgium	Free University of Brussels
institut saint jean baptiste de la salle brussels belgium	Free University of Brussels
intec brussel	Free University of Brussels
intec brussels	Free University of Brussels
intecbrussel	Free University of Brussels
international school of brussels	Free University of Brussels
isalt brussel	Free University of Brussels
k i h groep t leuven	Catholic University of Leuven
k u l leuven	Catholic University of Leuven
k u leuven	Catholic University of Leuven
ka2 de ring leuven	Catholic University of Leuven
ka3 gent	University of Ghent
kaho campus instituut te gent	Catholic University of Leuven
kamer voor handel en nijverheid van brussel	Free University of Brussels
kardinaal mercier brussel	Free University of Brussels
kardinaal mercierinst brussel	Free University of Brussels
kath hogeschool groep t leuven	Catholic University of Leuven
katho associatie kuleuven	Catholic University of Leuven
katho st lieven gent	University of Ghent
kathoieke universiteit leuven	Catholic University of Leuven
katholic universiteit leuven	Catholic University of Leuven
katholieke universiteit brussel	Free University of Brussels
katholieke universiteit leuven	Catholic University of Leuven
katholieke universiteit leuven k u leuven	Catholic University of Leuven
katholieke universiteit van leuven	Catholic University of Leuven
kdh antwerpen	University of Antwerp
kh leuven	Catholic University of Leuven
kh sint lieven gent	University of Ghent
khl leuven	Catholic University of Leuven
khleuven	Catholic University of Leuven
khlim hasselt	University of Hasselt
kho sint lieven gent	University of Ghent
kih groep t leuven	Catholic University of Leuven
kih oostende groep t leuven	Catholic University of Leuven
kih sint lieven gent	University of Ghent
kiha antwerpen	University of Antwerp
kihb leuven groep t	Catholic University of Leuven
kihl hasselt	University of Hasselt
kiho gent	University of Ghent
kiho sint lievens gent	University of Ghent
kisp gent	University of Ghent
klu leuven	Catholic University of Leuven
kms i s m erasmushogeschool brussel	Free University of Brussels
koninklijk atheneum redingenhof leuven	Catholic University of Leuven
kta gent	University of Ghent
kta i hasselt	University of Hasselt
ku leuven	Catholic University of Leuven
ku leuven belgium	Catholic University of Leuven
ku leuven campus	Catholic University of Leuven
ku leuven campus geel	Catholic University of Leuven
ku leuven campus groep t	Catholic University of Leuven
ku leuven campus groept	Catholic University of Leuven
ku leuven campus oostende	Catholic University of Leuven
ku leuven camus gent	Catholic University of Leuven
ku leuven faculty of engineering technology group t leuven campus	Catholic University of Leuven
ku leuven geel	Catholic University of Leuven
ku leuven gent	Catholic University of Leuven
kul	Catholic University of Leuven
kul afdeling kortrijk	Catholic University of Leuven
kul artesis	Catholic University of Leuven
kul campus geel	Catholic University of Leuven
kul leuven	Catholic University of Leuven
kul sint lucas gent	Catholic University of Leuven
kulak	Catholic University of Leuven
kulak kortrijk	Catholic University of Leuven
kulak ku leuven academie kortrijk	Catholic University of Leuven
kuleuven en uhasselt	University of Hasselt
kuleuven groept	Catholic University of Leuven
kuleuven kulak	Catholic University of Leuven
kuleuven ugent	University of Ghent
kvk antwerpen	University of Antwerp
language centre of leuven	University of Ghent
lbc antwerpen	University of Antwerp
lemmensinstituut leuven	Catholic University of Leuven
lessius antwerpen	University of Antwerp
lindelei gent	University of Ghent
lingopolis antwerpen	University of Antwerp
linguapolis antwerpen	University of Antwerp
linguapolis universiteit antwerpen	University of Antwerp
louvain	Catholic University of Leuven
louvain la neuve	Catholic University of Leuven
louvain school of engineering	Catholic University of Leuven
louvain school of management	Catholic University of Leuven
louvain school of management lsm universite catholique de louvain ucl	Catholic University of Leuven
louvain school of management ucl	Catholic University of Leuven
lucina vormingsinstituut kul	Catholic University of Leuven
mebs okulu ve egitim merkezi komutanligi	Catholic University of Leuven
miniemeninstituut leuven	Catholic University of Leuven
narafi brussel	Free University of Brussels
ocmw antwerpen	University of Antwerp
odisee gent	University of Ghent
odysee gent	University of Ghent
olvc antwerp	University of Antwerp
orthodox theologisch instituut heilige johannes de theoloog gent	Catholic University of Leuven
paridaens instituut leuven	Catholic University of Leuven
pestalozzi antwerpen	University of Antwerp
phhi hasselt	University of Hasselt
phitc antwerpen	University of Antwerp
phl hasselt	University of Hasselt
pih kortrijk en erasmushogeschool brussel	Free University of Brussels
pina antwerpen	University of Antwerp
pius x instituut antwerpen	Catholic University of Leuven
piva antwerpen	University of Antwerp
polytechnische school louvain la neuve	Catholic University of Leuven
provincie antwerpen	University of Antwerp
pvi antwerpen	University of Antwerp
pxl hasselt	University of Hasselt
r u gent	University of Ghent
race car erasmus hogeschool brussel	Free University of Brussels
rega instituut leuven	Catholic University of Leuven
rijksschool gent	University of Ghent
rijksuniversiteit gent	University of Ghent
rijksuniversiteit gent rug ir	University of Ghent
rijksuniverstiteit gent	University of Ghent
rits erasmushogeschool brussel	Free University of Brussels
royal conservatory brussels	Free University of Brussels
ru gent	University of Ghent
ruca antwerp	University of Antwerp
ruca antwerpen	University of Antwerp
rug gent	University of Ghent
rugent	University of Ghent
sae brussel	Free University of Brussels
sae brussels	Free University of Brussels
sae insitute brussel	Free University of Brussels
sae institute brussels	Free University of Brussels
sae instituut brussel	Free University of Brussels
scientifique contingent	University of Ghent
sint henricusinstituut te antwerpen	Catholic University of Leuven
sint lieven gent	University of Ghent
sint lievens gent	University of Ghent
sint lodewijck instituut antwerpen	Catholic University of Leuven
sint lucas hogeschool brussel	Free University of Brussels
sint lukas brussel	Free University of Brussels
sint lukas in brussel	Free University of Brussels
siveho antwerpen	University of Antwerp
sjb univ leuven	Free University of Brussels
solvay	Solvay Business School
solvay brussels school	Solvay Business School
solvay brussels school of economics and management	Solvay Business School
solvay business school	Solvay Business School
solvay business school vub	Solvay Business School
solvay université libre de bruxelles ulb	Solvay Business School
st lucas brussel	Free University of Brussels
st lucas cevora brussel	Free University of Brussels
staatsexamen brussel	Free University of Brussels
state university ghent	University of Ghent
stedelijk academie hasselt	University of Hasselt
stedelijk hoger instituut te antwerpen	Catholic University of Leuven
stedellijk centrum voor volwassenen onderwijs antwerpen	University of Antwerp
step hasselt	University of Hasselt
superior industrial institute of brussels	Free University of Brussels
syntra brussel	Free University of Brussels
technical instituut gent oostakker	Catholic University of Leuven
technical school of antwerp	University of Antwerp
technicum antwerp	University of Antwerp
technicum antwerpen	University of Antwerp
technisch instituut gent	Catholic University of Leuven
technisch instituut heilig hart hasselt	Catholic University of Leuven
technologie campus te gent	University of Ghent
temata groep t leuven	Catholic University of Leuven
temata group t leuven	Catholic University of Leuven
thomas more ku leuven	Catholic University of Leuven
tihh hasselt	University of Hasselt
u gent	University of Ghent
u hasselt	University of Hasselt
uams antwerpen	University of Antwerp
uc leuven	Catholic University of Leuven
ucl kul	Catholic University of Leuven
ucl louvain la neuve	Catholic University of Leuven
ucl universite catholique de louvain la neuve	Catholic University of Leuven
ucl univesite catholique de louvain la neuve	Catholic University of Leuven
uclouvain	Catholic University of Leuven
uclouvain université catholique de louvain	Catholic University of Leuven
ufsia universiteit antwerpen	University of Antwerp
uganda christian university	University of Ghent
ugent	University of Ghent
ugent omgezet	University of Ghent
uhasselt	University of Hasselt
uhasselt kuleuven	University of Hasselt
uia antwerpen	University of Antwerp
ulb vub	Free University of Brussels
unief gent	University of Ghent
uniersity of ghent belgium	University of Ghent
unif gent	University of Ghent
univ gent	University of Ghent
universitair centrum antwerpen	University of Antwerp
universitair gent	University of Ghent
universite catholique de louvain	Catholic University of Leuven
universite catholique de louvain la neuv	Catholic University of Leuven
universite catholique de louvain la neuve	Catholic University of Leuven
universite catholique de louvain u c l	Catholic University of Leuven
universite catholique de louvain ucl	Catholic University of Leuven
universite catholique de louvaine	Catholic University of Leuven
universite chatolique de louvain	Catholic University of Leuven
universite de louvain la neuve	Catholic University of Leuven
universiteit antwerpen	University of Antwerp
universiteit antwerpen ruca	University of Antwerp
universiteit gent	University of Ghent
universiteit gent campus kortrijk	University of Ghent
universiteit gent ugent	University of Ghent
universiteit hasselt	University of Hasselt
universiteit hasselt xios	University of Hasselt
universiteit in gent	University of Ghent
universiteit leuven	Catholic University of Leuven
universiteit ruca antwerpen	University of Antwerp
universiteit van antwerpen	University of Antwerp
universiteit van gent	University of Ghent
universiteit van louvain la neuve	Catholic University of Leuven
university gent	University of Ghent
university hasselt	University of Hasselt
university leuven	Catholic University of Leuven
university of antwerp	University of Antwerp
university of antwerp ufsia	University of Antwerp
university of brussels	Free University of Brussels
university of ghent	University of Ghent
university of ghent business engineering	University of Ghent
university of leuven	Catholic University of Leuven
university of leuven kul	Catholic University of Leuven
university saint louis brussels	Free University of Brussels
université catholique de louvain	Catholic University of Leuven
université catholique de louvain la neuve	Catholic University of Leuven
universteit gent	University of Ghent
uz leuven	Catholic University of Leuven
veiligheidsinstitutuut antwerpen	Catholic University of Leuven
verick management school leuven gent	Vlerick Business School
vizo hasselt	University of Hasselt
vlaamse universiteit brussel vub	Free University of Brussels
vlekho brussel	Solvay Business School
vlekho business school brussel	Solvay Business School
vlerick business academy	Vlerick Business School
vlerick business school	Vlerick Business School
vlerick business school siemens management leadership program	Vlerick Business School
vlerick leuven	Vlerick Business School
vlerick leuven gent management school	Vlerick Business School
vlerick leuven gent management school siemens	Vlerick Business School
vlerick leuven ghent management school	Vlerick Business School
vlerick management school	Vlerick Business School
vrij technisch instituut vti leuven	Catholic University of Leuven
vrije universiteit brussel	Free University of Brussels
vts technicum antwerp	University of Antwerp
vts technicum antwerpen	University of Antwerp
vtst antwerpen	University of Antwerp
vub	Free University of Brussels
vub brussel	Free University of Brussels
vub et universite d anvers	Free University of Brussels
vub kuleuven	Free University of Brussels
xios hasselt	University of Hasselt
zeemanschool antwerpen	University of Antwerp
